AddSpaceAndZone|AddSpaceAndZone.rtf
AllViews|AllViews.rtf
AnalyticalSupportData_Info|AnalyticalSupportData_Info.rtf
APIAppStartup|APIAppStartup.rtf
AppearanceAssetEditing|AppearanceAssetEditing.rtf
AreaReinCurve|AreaReinCurve.rtf
AreaReinParameters|AreaReinParameters.rtf
AttachedDetailGroup|AttachedDetailGroup.rtf
AutoRoute|AutoRoute.rtf
AutoTagRooms|AutoTagRooms.rtf
AvoidObstruction|AvoidObstruction.rtf
BeamAndSlabNewParameter|BeamAndSlabNewParameter.rtf
BoundaryConditions|BoundaryConditions.rtf
BrowseBindings||BrowseBindings.rtf
CapitalizeAllTextNotes|CapitalizeAllTextNotes.rtf
CloudAPISample|CloudAPISample.rtf
ColorFill|ColorFill.rtf
CompoundStructure|CompoundStructure.rtf
ContextualAnalyticalModel|ContextualAnalyticalModel.rtf
CreateBeamsColumnsBraces|CreateBeamsColumnsBraces.rtf
CreateBeamsColumnsBraces||CreateBeamsColumnsBraces.rtf
CreateBeamSystem|CreateBeamSystem.rtf
CreateComplexAreaRein|CreateComplexAreaRein.rtf
CreateDimensions|CreateDimensions.rtf
CreateDuctworkStiffener|CreateDuctworkStiffener.rtf
CreateFillPattern|CreateFillPattern.rtf
CreateShared||CreateShared.rtf
CreateSimpleAreaRein|CreateSimpleAreaRein.rtf
CreateTrianglesTopography|CreateTrianglesTopography.rtf
CreateViewSection|CreateViewSection.rtf
CreateWallinBeamProfile|CreateWallinBeamProfile.rtf
CreateWallsUnderBeams|CreateWallsUnderBeams.rtf
CurtainSystem|CurtainSystem.rtf
CurtainWallGrid|CurtainWallGrid.rtf
CurvedBeam|CurvedBeam.rtf
DatumsModification|DatumsModification.rtf
DeckProperties|DeckProperties.rtf
DeleteDimensions|DeleteDimensions.rtf
DeleteObject|DeleteObject.rtf
DesignOptionReader||DesignOptionReader.rtf
DimensionLeaderEnd|DimensionLeaderEnd.rtf
DirectionCalculation|DirectionCalculation.rtf
DisableCommand|DisableCommand.rtf
DisplacementElementAnimation|DisplacementElementAnimation.rtf
DockableDialogs|DockableDialogs.rtf
DocumentChanged|ChangesMonitor.rtf
DoorSwing|DoorSwing.rtf
DuplicateGraphics|DuplicateGraphics.rtf
DuplicateViews|DuplicateViews.rtf
DynamicModelUpdate|DynamicModelUpdate.rtf
ErrorHandling|ErrorHandling.rtf
ExportPDFSettingsSample|ExportPDFSettingsSample.rtf
ExtensibleStorageUtility|ExtensibleStorageUtility.rtf
FabricationPartLayout|FabricationPartLayout.rtf
FamilyParametersOrder|FamilyParametersOrder.rtf
FireRating||FireRating.rtf
FoundationSlab|FoundationSlab.rtf
FrameBuilder|FrameBuilder.rtf
FreeFormElement|FreeFormElement.rtf
GenerateFloor|GenerateFloor.rtf
GenericStructuralConnection|GenericStructuralConnection.rtf
GetSetDefaultTypes|GetSetDefaultTypes.rtf
GridCreation|GridCreation.rtf
HelloRevit|HelloRevit.rtf
HelloRevit||HelloRevit.rtf
ImportExport|ImportExport.rtf
InCanvasControlAPI|InCanvasControlAPI.rtf
InPlaceMembers|InPlaceMembers.rtf
InvisibleParam|InvisibleParam.rtf
Journaling|Journaling.rtf
LevelsProperty|LevelsProperty.rtf
Loads|Loads.rtf
MaterialProperties|MaterialProperties.rtf
MaterialProperties||MaterialProperties.rtf
MaterialQuantities|MaterialQuantities.rtf
ModelLines|ModelLines.rtf
MoveLinear|MoveLinear.rtf
MultiplanarRebar|MultiplanarRebar.rtf
NetworkPressureLossReport|NetworkPressureLossReport.rtf
NewHostedSweep|NewHostedSweep.rtf
NewOpenings|NewOpenings.rtf
NewPathReinforcement|NewPathReinforcement.rtf
NewRebar|NewRebar.rtf
NewRoof|NewRoof.rtf
Openings|Openings.rtf
PanelSchedule|PanelSchedule.rtf
ParameterUtils|ParameterUtils.rtf
PathOfTravel|PathOfTravel.rtf
PathReinforcement|PathReinforcement.rtf
PerformanceAdviserControl|PerformanceAdviserControl.rtf
PhaseSample||PhaseSample.rtf
PhysicalProp|PhysicalProp.rtf
PlaceFamilyInstanceByFace|PlaceFamilyInstanceByFace.rtf
PlacementOptions|PlacementOptions.rtf
PointCloudEngine|PointCloudEngine.rtf
PostCommandWorkflow|PostCommandWorkflow.rtf
PowerCircuit|PowerCircuit.rtf
ProjectInfo|ProjectInfo.rtf
ReadonlySharedParameters|ReadonlySharedParameters.rtf
RebarContainerAnyShapeType|RebarContainerAnyShapeType.rtf
RebarFreeForm|RebarFreeForm.rtf
ReferencePlane|ReferencePlane.rtf
Reinforcement|Reinforcement.rtf
RevitCommands||RevitCommands.rtf
Ribbon|Ribbon.rtf
RoofsRooms|RoofsRooms.rtf
Rooms|Rooms.rtf
RoomSchedule|RoomSchedule.rtf
RotateFramingObjects|RotateFramingObjects.rtf
RotateFramingObjects||RotateFramingObjects.rtf
RoutingPreferenceTools|RoutingPreferenceTools.rtf
RvtSamples|RvtSamples.rtf
ScheduleAutomaticFormatter|ScheduleAutomaticFormatter.rtf
ScheduleCreation|ScheduleCreation.rtf
ScheduleToHTML|ScheduleToHTML.rtf
Selections|Selections.rtf
ShaftHolePuncher|ShaftHolePuncher.rtf
SharedCoordinateSystem|SharedCoordinateSystem.rtf
SheetToView3D|SheetToView3D.rtf
SinePlotter|SinePlotter.rtf
Site|Site.rtf
SlabProperties|SlabProperties.rtf
SlabProperties||SlabProperties.rtf
SlabShapeEditing|SlabShapeEditing.rtf
SolidSolidCut|SolidSolidCut.rtf
SpanDirection|SpanDirection.rtf
SpotDimension|SpotDimension.rtf
StairsAutomation|StairsAutomationSample.rtf
StructSample|StructSample.rtf
StructuralLayerFunction|StructuralLayerFunction.rtf
StructuralLayerFunction||StructuralLayerFunction.rtf
TagBeam|TagBeam.rtf
TestFloorThickness||TestFloorThickness.rtf
TestWallThickness||TestWallThickness.rtf
Toposolid|Toposolid.rtf
TransactionControl|TransactionControl.rtf
TraverseSystem|TraverseSystem.rtf
Truss|Truss.rtf
TypeSelector||TypeSelector.rtf
UIAPI|UIAPI.rtf
Units|Units.rtf
VersionChecking|VersionChecking.rtf
ViewPrinter|ViewPrinter.rtf
ViewTemplateCreation|ViewTemplateCreation.rtf
VisibilityControl|VisibilityControl.rtf
WinderStairs|WinderStairs.rtf
AnalysisVisualizationFramework\DistanceToSurfaces|DistanceToSurfaces.rtf
AnalysisVisualizationFramework\MultithreadedCalculation|MultithreadedCalculation.rtf
AnalysisVisualizationFramework\SpatialFieldGradient|SpatialFieldGradient.rtf
CustomExporter\Custom2DExporter|Custom2DExporter.rtf
ElementFilter\ViewFilters|ViewFilters.rtf
Events\AutoStamp|AutoStamp.rtf
Events\AutoUpdate|AutoUpdate.rtf
Events\CancelSave|CancelSave.rtf
Events\EventsMonitor|EventsMonitor.rtf
Events\PrintLog|PrintLog.rtf
Events\ProgressNotifier|ProgressNotifier.rtf
Events\SelectionChanged|SelectionChanged.rtf
ExtensibleStorageManager\ExtensibleStorageManager|ExtensibleStorageManager.rtf
ExtensibleStorageManager\SchemaWrapperTools|SchemaWrapperTools.rtf
ExternalResourceServer\ExternalResourceDBServer|ExternalResourceDBServer.rtf
ExternalResourceServer\ExternalResourceUIServer|ExternalResourceUIServer.rtf
FamilyCreation\AutoJoin|AutoJoin.rtf
FamilyCreation\AutoParameter|AutoParameter.rtf
FamilyCreation\CreateAirHandler|CreateAirHandler.rtf
FamilyCreation\CreateTruss|CreateTruss.rtf
FamilyCreation\DWGFamilyCreation|DWGFamilyCreation.rtf
FamilyCreation\GenericModelCreation|GenericModelCreation.rtf
FamilyCreation\TypeRegeneration|TypeRegeneration.rtf
FamilyCreation\ValidateParameters|ValidateParameters.rtf
FamilyCreation\WindowWizard|WindowWizard.rtf
FindReferencesByDirection\FindColumns|FindColumns.rtf
FindReferencesByDirection\MeasureHeight|MeasureHeight.rtf
FindReferencesByDirection\RaytraceBounce|RaytraceBounce.rtf
GeometryAPI\BRepBuilderExample|BRepBuilderExample.rtf
GeometryAPI\ComputedSymbolGeometry|ComputedSymbolGeometry.rtf
GeometryAPI\EnergyAnalysisModel|EnergyAnalysisModel.rtf
GeometryAPI\GeometryCreation_BooleanOperation|GeometryCreation_BooleanOperation.rtf
GeometryAPI\ProximityDetection_WallJoinControl|ProximityDetection_WallJoinControl.rtf
GeometryAPI\UpdateExternallyTaggedBRep|UpdateExternallyTaggedBRep.rtf
Massing\DistanceToPanels|DistanceToPanels.rtf
Massing\DividedSurfaceByIntersects|DividedSurfaceByIntersects.rtf
Massing\ManipulateForm|ManipulateForm.rtf
Massing\MeasurePanelArea|MeasurePanelArea.rtf
Massing\NewForm|NewForm.rtf
Massing\PanelEdgeLengthAngle|PanelEdgeLengthAngle.rtf
Massing\ParameterValuesFromImage|ParameterValuesFromImage.rtf
Massing\PointCurveCreation|PointCurveCreation.rtf
ModelessDialog\ModelessForm_ExternalEvent|ModelessForm_ExternalEvent.rtf
ModelessDialog\ModelessForm_IdlingEvent|ModelessForm_IdlingEvent.rtf
MultiThreading\WorkThread|WorkThread.rtf
Viewers\AnalyticalViewer||AnalyticalViewer.rtf
Viewers\ElementViewer||ElementViewer.rtf
Viewers\RevitViewer||RevitViewer.rtf
Viewers\RoomViewer||RoomViewer.rtf
